maze = [
    ["S"," ","#"," "," "," ","#"," "," "," "],
    ["#"," ","#"," ","#"," ","#"," ","#"," "],
    [" "," "," "," ","#"," "," "," ","#"," "],
    [" ","#","#"," ","#"," ","#"," ","#"," "],
    [" ","#"," "," "," "," ","#"," "," "," "],
    [" ","#"," ","#","#"," ","#"," ","#"," "],
    [" "," "," ","#"," "," "," "," ","#"," "],
    ["#"," ","#"," ","#"," ","#"," ","#"," "],
    [" "," ","#"," "," "," "," "," ","#"," "],
    [" ","#"," ","#"," ","#"," "," "," ","G"]
]
