maze = [
    ["S"," ","#"," "," "," ","#"," "," "," ","#"," "," "," "," "],
    ["#"," ","#"," ","#"," ","#"," ","#"," ","#"," ","#"," "," "],
    [" "," "," "," ","#"," "," "," ","#"," "," "," ","#"," "," "],
    [" ","#","#"," ","#"," ","#"," ","#"," ","#"," ","#"," "," "],
    [" ","#"," "," "," "," ","#"," "," "," ","#"," "," "," "," "],
    [" ","#"," ","#","#"," ","#"," ","#"," ","#"," ","#"," "," "],
    [" "," "," ","#"," "," "," "," ","#"," "," "," ","#"," "," "],
    ["#"," ","#"," ","#"," ","#"," ","#"," ","#"," ","#"," "," "],
    [" "," ","#"," "," "," "," "," ","#"," "," "," "," "," "," "],
    [" ","#"," ","#"," ","#"," ","#"," ","#"," ","#"," ","#"," "],
    [" "," "," "," ","#"," "," "," ","#"," "," "," ","#"," "," "],
    ["#"," ","#"," ","#"," ","#"," ","#"," ","#"," ","#"," "," "],
    [" "," ","#"," "," "," "," "," ","#"," "," "," ","#"," "," "],
    [" ","#"," ","#"," ","#"," ","#"," ","#"," ","#"," ","#"," "],
    [" "," "," ","#"," "," "," "," "," "," ","#"," "," "," ","G"]
]
