maze = [
    ["S", " ", "#", "#", "#", "#", "#", "#", "#", "#", "#", "#", "#", "#", "#", "#", "#", "#", "#", "#"],
    ["#", " ", "#", " ", " ", " ", " ", "#", " ", " ", " ", " ", "#", " ", " ", " ", "#", " ", " ", "#"],
    ["#", " ", "#", " ", "#", "#", " ", "#", " ", "#", "#", "#", "#", " ", "#", " ", "#", " ", "#", "#"],
    ["#", " ", " ", " ", "#", " ", " ", " ", " ", "#", " ", " ", "#", " ", "#", " ", " ", " ", "#", "#"],
    ["#", "#", "#", " ", "#", " ", "#", "#", " ", "#", " ", "#", "#", " ", "#", "#", "#", " ", "#", "#"],
    ["#", " ", " ", " ", "#", " ", "#", " ", " ", " ", " ", "#", "#", " ", "#", " ", "#", " ", " ", "#"],
    ["#", "#", "#", "#", "#", " ", "#", " ", "#", "#", "#", " ", "#", "#", "#", " ", "#", "#", " ", "#"],
    ["#", " ", "#", " ", " ", " ", " ", " ", "#", " ", " ", " ", " ", " ", "#", " ", " ", "#", " ", "#"],
    ["#", " ", "#", " ", "#", "#", "#", "#", "#", " ", "#", "#", "#", " ", "#", "#", " ", "#", " ", "#"],
    ["#", " ", " ", " ", " ", " ", " ", " ", " ", " ", "#", " ", " ", " ", " ", "#", " ", " ", " ", "#"],
    ["#", "#", "#", "#", "#", "#", "#", "#", " ", "#", "#", " ", "#", "#", "#", "#", "#", "#", " ", "#"],
    ["#", " ", " ", " ", " ", " ", " ", " ", " ", "#", " ", " ", " ", " ", " ", " ", " ", " ", " ", "#"],
    ["#", " ", "#", "#", "#", " ", "#", "#", " ", "#", "#", "#", "#", " ", "#", " ", "#", "#", " ", "#"],
    ["#", " ", " ", " ", "#", " ", " ", "#", " ", " ", " ", "#", " ", " ", "#", " ", " ", "#", " ", "#"],
    ["#", "#", "#", " ", "#", "#", " ", "#", "#", "#", " ", "#", " ", "#", "#", " ", "#", "#", " ", "#"],
    ["#", " ", " ", " ", " ", "#", " ", " ", " ", "#", " ", " ", " ", "#", " ", " ", " ", "#", " ", "#"],
    ["#", " ", "#", "#", " ", "#", "#", "#", " ", "#", " ", "#", " ", "#", "#", "#", " ", "#", "#", "#"],
    ["#", " ", " ", "#", " ", " ", " ", "#", " ", " ", " ", "#", " ", " ", " ", "#", " ", " ", " ", "#"],
    ["#", "#", " ", "#", "#", "#", " ", "#", "#", "#", " ", "#", "#", "#", " ", "#", "#", "#", " ", " "],
    ["#", "#", "#", "#", "#", "#", "#", "#", "#", "#", "#", "#", "#", "#", "#", "#", "#", "#", "#", "G"]
]
