maze = [
    ["S","#"," ","#","#"," ","#"," ","#","#"," ","#","#","#"," ","#"," ","#","#","#","#"," ","#"," ","#","#"," ","#"," ","#","#"," ","#"," ","#","#"," ","#"," ","#","#"],
    [" "," "," ","#"," "," ","#"," "," "," ","#"," ","#"," ","#"," "," ","#"," ","#"," ","#"," ","#","#"," ","#","#"," "," ","#"," ","#"," ","#"," "," ","#","#"," "," "],
    ["#","#"," ","#"," ","#","#","#","#","#","#","#","#","#"," ","#","#","#"," ","#"," ","#"," ","#","#","#"," ","#","#"," ","#","#","#","#"," ","#","#"," ","#","#","#"],
    ["#"," "," "," "," ","#"," "," "," ","#"," "," "," "," "," ","#"," ","#"," ","#","#"," "," ","#","#"," ","#","#"," "," "," "," ","#"," ","#"," "," "," ","#"," ","#"],
    ["#","#","#","#"," ","#","#","#"," ","#","#","#","#"," ","#","#","#","#","#","#"," ","#","#","#","#","#","#","#","#","#","#","#"," ","#","#","#","#","#","#","#","#"],
    ["#"," "," ","#"," "," "," ","#"," "," "," ","#"," "," ","#"," "," "," ","#"," "," ","#"," ","#"," ","#"," "," ","#"," "," ","#"," ","#"," "," "," ","#"," "," ","#"],
    ["#","#"," ","#","#","#"," ","#","#","#","#","#","#","#","#","#","#","#","#","#","#","#","#","#","#","#","#","#","#","#","#","#","#","#","#","#","#","#","#","#","#"],
    ["#"," "," "," ","#"," "," "," ","#"," "," "," ","#"," "," ","#"," ","#"," ","#"," "," "," ","#"," "," ","#"," ","#"," ","#"," "," "," ","#"," ","#"," "," "," ","#"],
    ["#"," ","#"," ","#","#"," ","#","#","#","#","#"," ","#","#","#","#","#","#","#","#","#","#","#","#","#","#","#","#","#","#","#","#","#","#","#","#","#","#","#","#"],
    ["#"," ","#"," "," "," "," "," ","#"," "," "," ","#"," "," ","#"," ","#"," ","#"," ","#"," "," "," ","#"," ","#"," ","#"," ","#"," "," "," ","#"," ","#"," "," ","#"],
    ["#"," ","#","#","#","#","#","#","#","#","#","#","#","#","#","#","#","#","#","#","#","#","#","#","#","#","#","#","#","#","#","#","#","#","#","#","#","#","#","#","#"],
    ["#"," "," ","#"," "," "," ","#"," "," "," "," "," "," ","#"," "," "," ","#"," ","#"," ","#"," "," "," ","#"," "," "," ","#"," ","#"," "," "," ","#"," "," "," ","#"],
    ["#"," ","#","#","#"," ","#","#","#","#","#","#","#","#","#","#","#","#","#","#","#","#","#","#","#","#","#","#","#","#","#","#","#","#","#","#","#","#","#","#","#"],
    ["#"," "," ","#"," "," ","#"," "," "," ","#"," "," "," ","#"," "," ","#"," ","#"," ","#"," "," "," ","#"," "," ","#"," "," ","#"," ","#"," "," ","#"," ","#"," ","#"],
    ["#"," ","#","#","#"," ","#","#","#","#","#","#","#","#","#","#","#","#","#","#","#","#","#","#","#","#","#","#","#","#","#","#","#","#","#","#","#","#","#","#","#"],
    ["#"," ","#"," "," "," ","#"," "," "," ","#"," "," "," ","#"," "," ","#"," ","#"," ","#"," "," "," ","#"," "," ","#"," "," ","#"," ","#"," "," ","#"," ","#"," ","#"],
    ["#"," ","#","#","#","#","#","#","#","#","#","#","#","#","#","#","#","#","#","#","#","#","#","#","#","#","#","#","#","#","#","#","#","#","#","#","#","#","#","#","#"],
    ["#"," "," "," ","#"," "," "," ","#"," "," "," ","#"," "," ","#"," ","#"," ","#"," "," "," ","#"," "," "," ","#"," "," ","#"," ","#"," "," "," ","#"," "," "," ","#"],
    ["#","#","#"," ","#"," ","#"," ","#","#","#","#","#","#","#","#","#","#","#","#","#","#","#","#","#","#","#","#","#","#","#","#","#","#","#","#","#","#","#","#","#"],
    ["#"," ","#"," "," "," ","#"," "," "," ","#"," "," "," ","#"," "," ","#"," ","#"," ","#"," "," "," ","#"," "," ","#"," "," ","#"," ","#"," "," ","#"," ","#"," ","#"],
    ["#"," ","#","#","#","#","#","#","#"," ","#","#","#","#","#","#","#","#","#","#","#","#","#","#","#","#","#","#","#","#","#","#","#","#","#","#","#","#","#","#","#"],
    ["#"," "," ","#"," "," ","#"," "," "," "," "," "," "," ","#"," "," ","#"," ","#"," ","#"," "," "," ","#"," "," ","#"," "," ","#"," ","#"," "," ","#"," ","#"," ","#"],
    ["#","#","#","#","#","#","#","#","#","#","#"," ","#","#","#","#","#","#","#","#","#","#","#","#","#","#","#","#","#","#","#","#","#","#","#","#","#","#","#","#","#"],
    ["#"," "," ","#"," "," ","#"," "," "," ","#"," "," "," "," "," "," ","#"," ","#"," ","#"," "," "," ","#"," "," "," "," "," ","#"," ","#"," "," ","#"," ","#"," ","#"],
    ["#","#","#","#","#","#","#","#","#","#","#","#","#","#","#","#"," ","#","#","#","#","#","#","#","#","#"," ","#","#"," ","#","#","#","#","#","#","#","#","#","#","#"],
    ["#"," "," ","#"," "," ","#"," "," "," ","#"," "," "," ","#"," "," ","#"," ","#"," ","#"," "," "," "," "," "," ","#"," "," ","#"," ","#"," "," ","#"," ","#"," ","#"],
    ["#","#","#","#","#","#","#","#","#","#","#","#","#","#","#","#"," "," "," ","#","#","#","#"," ","#","#"," ","#","#","#"," ","#","#","#","#","#","#","#","#","#","#"],
    ["#"," "," ","#"," "," ","#"," "," "," ","#"," "," "," ","#"," "," ","#"," "," "," "," "," "," "," ","#"," "," ","#"," "," ","#"," ","#"," "," ","#"," ","#"," ","#"],
    ["#","#","#","#","#","#","#","#","#","#","#","#","#","#","#","#","#","#","#","#","#","#","#","#","#","#","#"," ","#"," ","#","#","#","#","#","#","#","#","#","#","#"],
    ["#"," "," ","#"," "," ","#"," "," "," ","#"," "," "," ","#"," "," ","#"," ","#"," ","#"," "," "," ","#"," "," ","#"," "," "," "," "," "," "," ","#"," "," "," ","#"],
    ["#","#","#","#","#","#","#","#","#","#","#","#","#","#","#","#","#","#","#","#","#","#","#","#","#","#","#"," ","#","#","#","#","#"," ","#","#","#"," ","#"," ","#"],
    ["#"," "," ","#"," "," ","#"," "," "," ","#"," "," "," ","#"," "," ","#"," ","#"," ","#"," "," "," ","#"," "," ","#"," "," ","#"," "," "," "," ","#"," ","#"," ","#"],
    ["#","#","#","#","#","#","#","#","#","#","#","#","#","#","#","#","#","#","#","#","#","#","#","#","#","#","#","#","#","#","#","#","#","#","#"," ","#"," ","#"," ","#"],
    ["#"," "," ","#"," "," ","#"," "," "," ","#"," "," "," ","#"," "," ","#"," ","#"," ","#"," "," "," ","#"," "," ","#"," "," ","#"," ","#"," "," "," "," ","#"," ","G"]
]
