maze = [
    ['S', ' ', ' ', ' ', ' ', ' ', ' ', ' ', ' ', '#', ' ', ' ', ' ', '#', ' ', ' ', ' ', ' ', ' ', ' ', ' ', ' ', ' ', ' ', ' ', '#', ' ', ' ', ' ', ' ', ' ', ' ', ' ', '#', ' ', ' ', ' ', ' ', ' ', '#'],
    [' ', '#', '#', '#', '#', '#', ' ', '#', ' ', '#', ' ', '#', ' ', '#', '#', '#', '#', '#', ' ', '#', '#', '#', ' ', '#', ' ', '#', '#', '#', ' ', '#', '#', '#', ' ', '#', ' ', '#', '#', '#', '#', '#'],
    [' ', ' ', ' ', '#', ' ', ' ', ' ', '#', ' ', '#', ' ', '#', ' ', ' ', ' ', ' ', ' ', '#', ' ', ' ', ' ', '#', ' ', '#', ' ', '#', ' ', ' ', ' ', '#', ' ', ' ', ' ', '#', ' ', ' ', ' ', ' ', ' ', '#'],
    ['#', '#', ' ', '#', ' ', '#', '#', '#', ' ', '#', ' ', '#', '#', '#', '#', '#', ' ', '#', '#', '#', ' ', '#', ' ', '#', ' ', '#', ' ', '#', '#', '#', '#', '#', ' ', '#', '#', '#', '#', '#', ' ', '#'],
    [' ', '#', ' ', ' ', ' ', '#', ' ', '#', ' ', '#', ' ', ' ', ' ', '#', ' ', '#', ' ', '#', ' ', '#', ' ', '#', ' ', '#', ' ', '#', ' ', ' ', ' ', ' ', ' ', '#', ' ', ' ', ' ', '#', ' ', ' ', ' ', '#'],
    [' ', '#', '#', '#', '#', '#', ' ', '#', ' ', '#', ' ', '#', ' ', '#', ' ', '#', ' ', '#', ' ', '#', ' ', '#', ' ', '#', ' ', '#', '#', '#', '#', '#', ' ', '#', '#', '#', ' ', '#', ' ', '#', ' ', '#'],
    [' ', ' ', ' ', ' ', ' ', ' ', ' ', '#', ' ', '#', ' ', '#', ' ', '#', ' ', ' ', ' ', '#', ' ', ' ', ' ', '#', ' ', '#', ' ', ' ', ' ', ' ', ' ', '#', ' ', ' ', ' ', '#', ' ', ' ', ' ', '#', ' ', '#'],
    [' ', '#', '#', '#', '#', '#', ' ', '#', ' ', '#', '#', '#', ' ', '#', ' ', '#', '#', '#', '#', '#', ' ', '#', ' ', '#', '#', '#', '#', '#', ' ', '#', ' ', '#', ' ', '#', '#', '#', '#', '#', ' ', '#'],
    [' ', ' ', ' ', ' ', ' ', '#', ' ', '#', ' ', ' ', ' ', ' ', ' ', '#', ' ', ' ', ' ', ' ', ' ', '#', ' ', '#', ' ', '#', ' ', ' ', ' ', ' ', ' ', '#', ' ', '#', ' ', '#', ' ', '#', ' ', ' ', ' ', '#'],
    [' ', '#', '#', '#', ' ', '#', '#', '#', '#', '#', '#', '#', '#', '#', '#', '#', '#', '#', ' ', '#', '#', '#', ' ', '#', '#', '#', ' ', '#', '#', '#', '#', '#', ' ', '#', ' ', '#', ' ', '#', '#', '#'],
    [' ', '#', ' ', ' ', ' ', '#', ' ', ' ', ' ', ' ', ' ', ' ', ' ', ' ', ' ', ' ', ' ', '#', ' ', ' ', ' ', '#', ' ', ' ', ' ', '#', ' ', ' ', ' ', ' ', ' ', ' ', ' ', '#', ' ', ' ', ' ', '#', ' ', '#'],
    [' ', '#', ' ', '#', '#', '#', ' ', '#', ' ', '#', '#', '#', ' ', '#', '#', '#', '#', '#', '#', '#', ' ', '#', ' ', '#', ' ', '#', '#', '#', '#', '#', '#', '#', ' ', '#', ' ', '#', '#', '#', ' ', '#'],
    [' ', '#', ' ', '#', ' ', ' ', ' ', '#', ' ', '#', ' ', ' ', ' ', '#', ' ', ' ', ' ', ' ', ' ', '#', ' ', '#', ' ', '#', ' ', ' ', ' ', ' ', ' ', '#', ' ', '#', ' ', ' ', ' ', '#', ' ', ' ', ' ', '#'],
    ['#', '#', ' ', '#', ' ', '#', '#', '#', ' ', '#', '#', '#', '#', '#', ' ', '#', '#', '#', ' ', '#', ' ', '#', '#', '#', ' ', '#', '#', '#', ' ', '#', ' ', '#', ' ', '#', ' ', '#', '#', '#', ' ', '#'],
    [' ', ' ', ' ', '#', ' ', ' ', ' ', '#', ' ', ' ', ' ', ' ', ' ', ' ', ' ', '#', ' ', ' ', ' ', '#', ' ', ' ', ' ', '#', ' ', ' ', ' ', '#', ' ', '#', ' ', '#', ' ', '#', ' ', ' ', ' ', '#', ' ', '#'],
    [' ', '#', '#', '#', '#', '#', ' ', '#', '#', '#', '#', '#', '#', '#', '#', '#', ' ', '#', ' ', '#', '#', '#', ' ', '#', '#', '#', '#', '#', ' ', '#', ' ', '#', ' ', '#', ' ', '#', ' ', '#', ' ', '#'],
    [' ', ' ', ' ', ' ', ' ', '#', ' ', '#', ' ', ' ', ' ', ' ', ' ', ' ', ' ', '#', ' ', '#', ' ', '#', ' ', ' ', ' ', '#', ' ', ' ', ' ', ' ', ' ', '#', ' ', ' ', ' ', '#', ' ', '#', ' ', ' ', ' ', '#'],
    [' ', '#', '#', '#', ' ', '#', ' ', '#', '#', '#', '#', '#', ' ', '#', ' ', '#', ' ', '#', '#', '#', ' ', '#', '#', '#', ' ', '#', '#', '#', '#', '#', ' ', '#', '#', '#', ' ', '#', '#', '#', ' ', '#'],
    [' ', ' ', ' ', '#', ' ', '#', ' ', '#', ' ', ' ', ' ', '#', ' ', '#', ' ', '#', ' ', ' ', ' ', '#', ' ', '#', ' ', ' ', ' ', '#', ' ', ' ', ' ', '#', ' ', ' ', ' ', ' ', ' ', '#', ' ', ' ', ' ', '#'],
    ['#', '#', '#', '#', ' ', '#', ' ', '#', ' ', '#', ' ', '#', '#', '#', ' ', '#', '#', '#', ' ', '#', ' ', '#', ' ', '#', ' ', '#', ' ', '#', ' ', '#', '#', '#', '#', '#', '#', '#', ' ', '#', '#', '#'],
    [' ', ' ', ' ', '#', ' ', '#', ' ', '#', ' ', '#', ' ', ' ', ' ', ' ', ' ', '#', ' ', '#', ' ', '#', ' ', '#', ' ', '#', ' ', ' ', ' ', '#', ' ', ' ', ' ', '#', ' ', ' ', ' ', '#', ' ', ' ', ' ', '#'],
    [' ', '#', ' ', '#', ' ', '#', ' ', '#', ' ', '#', '#', '#', '#', '#', ' ', '#', ' ', '#', ' ', '#', ' ', '#', ' ', '#', '#', '#', '#', '#', '#', '#', ' ', '#', ' ', '#', '#', '#', '#', '#', ' ', '#'],
    [' ', '#', ' ', ' ', ' ', '#', ' ', ' ', ' ', '#', ' ', ' ', ' ', '#', ' ', ' ', ' ', '#', ' ', ' ', ' ', '#', ' ', ' ', ' ', ' ', ' ', ' ', ' ', '#', ' ', '#', ' ', ' ', ' ', ' ', ' ', ' ', ' ', '#'],
    [' ', '#', '#', '#', '#', '#', '#', '#', '#', '#', ' ', '#', '#', '#', '#', '#', ' ', '#', '#', '#', '#', '#', '#', '#', ' ', '#', '#', '#', '#', '#', ' ', '#', ' ', '#', '#', '#', '#', '#', '#', '#'],
    [' ', ' ', ' ', ' ', ' ', ' ', ' ', ' ', ' ', '#', ' ', ' ', ' ', ' ', ' ', '#', ' ', ' ', ' ', ' ', ' ', ' ', ' ', '#', ' ', '#', ' ', ' ', ' ', ' ', ' ', '#', ' ', '#', ' ', ' ', ' ', ' ', ' ', '#'],
    ['#', '#', '#', '#', ' ', '#', '#', '#', ' ', '#', '#', '#', ' ', '#', ' ', '#', '#', '#', '#', '#', '#', '#', ' ', '#', ' ', '#', ' ', '#', '#', '#', '#', '#', ' ', '#', ' ', '#', ' ', '#', '#', '#'],
    [' ', ' ', ' ', ' ', ' ', '#', ' ', ' ', ' ', ' ', ' ', ' ', ' ', '#', ' ', ' ', ' ', '#', ' ', ' ', ' ', ' ', ' ', '#', ' ', '#', ' ', '#', ' ', ' ', ' ', '#', ' ', '#', ' ', '#', ' ', ' ', ' ', '#'],
    [' ', '#', '#', '#', '#', '#', '#', '#', '#', '#', '#', '#', '#', '#', ' ', '#', '#', '#', ' ', '#', '#', '#', '#', '#', '#', '#', ' ', '#', ' ', '#', ' ', '#', ' ', '#', ' ', '#', '#', '#', ' ', '#'],
    [' ', ' ', ' ', ' ', ' ', ' ', ' ', '#', ' ', ' ', ' ', ' ', ' ', ' ', ' ', '#', ' ', ' ', ' ', '#', ' ', ' ', ' ', '#', ' ', ' ', ' ', '#', ' ', '#', ' ', '#', ' ', '#', ' ', '#', ' ', ' ', ' ', '#'],
    ['#', '#', '#', '#', ' ', '#', ' ', '#', ' ', '#', '#', '#', '#', '#', '#', '#', ' ', '#', '#', '#', ' ', '#', ' ', '#', ' ', '#', '#', '#', ' ', '#', ' ', '#', ' ', '#', '#', '#', ' ', '#', ' ', '#'],
    [' ', ' ', ' ', '#', ' ', '#', ' ', '#', ' ', ' ', ' ', ' ', ' ', '#', ' ', ' ', ' ', '#', ' ', ' ', ' ', '#', ' ', ' ', ' ', '#', ' ', '#', ' ', '#', ' ', '#', ' ', ' ', ' ', ' ', ' ', '#', ' ', '#'],
    [' ', '#', ' ', '#', ' ', '#', ' ', '#', '#', '#', '#', '#', '#', '#', ' ', '#', '#', '#', ' ', '#', '#', '#', '#', '#', '#', '#', ' ', '#', ' ', '#', ' ', '#', '#', '#', '#', '#', '#', '#', ' ', '#'],
    [' ', '#', ' ', '#', ' ', '#', ' ', '#', ' ', ' ', ' ', '#', ' ', ' ', ' ', '#', ' ', ' ', ' ', '#', ' ', ' ', ' ', '#', ' ', ' ', ' ', ' ', ' ', '#', ' ', '#', ' ', ' ', ' ', ' ', ' ', '#', ' ', '#'],
    [' ', '#', ' ', '#', '#', '#', ' ', '#', ' ', '#', ' ', '#', ' ', '#', '#', '#', '#', '#', ' ', '#', ' ', '#', ' ', '#', '#', '#', '#', '#', '#', '#', ' ', '#', ' ', '#', ' ', '#', '#', '#', ' ', '#'],
    [' ', '#', ' ', ' ', ' ', ' ', ' ', '#', ' ', '#', ' ', '#', ' ', ' ', ' ', ' ', ' ', '#', ' ', '#', ' ', '#', ' ', ' ', ' ', ' ', ' ', '#', ' ', ' ', ' ', '#', ' ', '#', ' ', ' ', ' ', ' ', ' ', '#'],
    [' ', '#', ' ', '#', '#', '#', '#', '#', ' ', '#', ' ', '#', '#', '#', '#', '#', ' ', '#', ' ', '#', ' ', '#', '#', '#', '#', '#', ' ', '#', ' ', '#', '#', '#', ' ', '#', '#', '#', '#', '#', '#', '#'],
    [' ', '#', ' ', '#', ' ', ' ', ' ', '#', ' ', '#', ' ', ' ', ' ', ' ', ' ', '#', ' ', '#', ' ', ' ', ' ', ' ', ' ', '#', ' ', ' ', ' ', '#', ' ', ' ', ' ', ' ', ' ', '#', ' ', ' ', ' ', ' ', ' ', '#'],
    [' ', '#', '#', '#', ' ', '#', ' ', '#', ' ', '#', ' ', '#', '#', '#', '#', '#', ' ', '#', '#', '#', '#', '#', '#', '#', ' ', '#', '#', '#', ' ', '#', '#', '#', '#', '#', '#', '#', '#', '#', ' ', '#'],
    [' ', ' ', ' ', ' ', ' ', '#', ' ', ' ', ' ', '#', ' ', ' ', ' ', ' ', ' ', ' ', ' ', ' ', ' ', ' ', ' ', ' ', ' ', ' ', ' ', '#', ' ', ' ', ' ', ' ', ' ', ' ', ' ', ' ', ' ', ' ', ' ', ' ', ' ', '#'],
    ['#', '#', '#', '#', '#', '#', '#', '#', '#', '#', '#', '#', '#', '#', '#', '#', '#', '#', '#', '#', '#', '#', '#', '#', '#', '#', '#', '#', '#', '#', '#', '#', '#', '#', '#', '#', '#', '#', ' ', 'G'],
]
